111111
1P00C1
110111
110E11
111111