111111
1P00C1
101101
100E11
111111