1111111111
1C00C000C1
10C11C0001
101E111C01
1P10C00001
1111111111