11111
100P1
1C001
100E1
11111
