1111111111
10000000C1
1001100001
101E111001
1P10000001
1111111111