111111111
1000E0001
1000C0001
100000001
100000001
100000001
100000001
1000P0001
111111111