111111111
1P0000001
1000100C1
111010111
1C0010001
101111101
1000100C1
111010111
1E00000C1
111101111