11111111111
1CPCCCCC001
100CCCCC001
100CCCCC001
100CCCCC001
1E0CCCCC0F1
11111111111