11111111111111111111111111111111111111111111111111111111
1CPCCCCC000000000000000000000000000000000000000000000001
100CCCCC000000000000000000000000000000000000000000000001
100CCCCC000000000000000000000000000000000000000000000001
100CCCCC000000000000000000000000000000000000000000000001
1E0CCCCC000000000000000000000000000000000000000000000001
11111111111111111111111111111111111111111111111111111111